NO ./spt/N.xpm
SO ./spt/S.xpm
WE ./spt/W.xpm
EA ./spt/E.xpm

C 0,0,0
F 0,0,0

        1111111111111111111111111
        1000000000110000000000001
        1011000001110000000000001
        1001000000000000000000001
111111111011000001110000000000001
100000000011000001110111111111111
11110111111111011100000010001
11110111111111011101010010001
11000000110101011100000010001
100000000010000011000000100011
10000E000000100001101010000001
110000011101010111110111100111
11110111 1110101 101111010001
11111111 1111111 111111111111