EA ./spt/red.xpm
SO ./spt/green.xpm
WE ./spt/floor.xpm
NO ./spt/wall.xpm

F 2,5,200
C 19,3,200

          1111111111
11111111111100000011
10000000000000000011    1111111
1000000001111111111     1000001
10000000001             1000001
11111111101             1000001
        10111111111111111111101
        10000000000000000000001
        10000000000N00000000001
        11000000000000000000001
        11111111111111111111111